#####
#P..#
#.#.#
#...#
#####
